RIL	Ashared	Eshared	ParentShared	UniqueFromParents	UniqueFromAllOthers	Total
A123-0_1	461	19	461	0	0	461
A123-2_1	338	19	338	0	0	338
EG4-1_1	25	681	681	0	0	681
EG4-2_1	21	506	506	0	0	506
RIL2-1	114	152	254	320	197	574
RIL2-2	134	129	250	289	195	539
RIL2-3	117	148	250	280	193	530
RIL2-4	116	229	330	322	201	652
RIL2-5	112	152	251	294	194	545
RIL2-6	111	186	287	412	290	699
RIL2-7	96	221	302	262	139	564
RIL2-8	108	181	274	280	175	554
