RIL	Total	Parental	SharedAParents	SharedEParents	NonParental	NonParental_Shared_w_otherRILs	Unique
A123-0_1	461	461	461	19	0	0	0
A123-2_1	338	338	338	19	0	0	0
EG4-1_1	681	681	25	681	0	0	0
EG4-2_1	506	506	21	506	0	0	0
RIL2-1	574	254	114	152	320	313	197
RIL2-2	539	250	134	129	289	239	195
RIL2-3	530	250	117	148	280	230	193
RIL2-4	652	330	116	229	322	315	201
RIL2-5	545	251	112	152	294	287	194
RIL2-6	699	287	111	186	412	306	290
RIL2-7	564	302	96	221	262	340	139
RIL2-8	554	274	108	181	280	308	175
